+-+-+-+-+-+-+-+-+-+-+-+-+-+-+-+-+-+-+-+-+
E |   |         |   |     |     |       |
+ + + + +-+-+-+ + +-+ +-+ + +-+ +-+-+-+ +
| | | |       |   |   |   | |   |     | |
+ + + +-+-+-+-+-+ + +-+-+-+-+ +-+ +-+ + +
|   |       |   | |     |     |   |   | |
+-+-+ +-+-+ + + + +-+ + + + +-+ +-+ +-+ +
|     |   | | | |   | | | |   | |     | |
+-+-+-+ +-+ + + +-+ + + + +-+-+ + +-+ + +
|     |   |   |     | | | |   | | |   | |
+ + +-+-+ +-+-+ +-+-+-+ + + + + +-+ +-+ +
| | |           |       |   | |   | | | |
+ + + +-+-+-+-+-+ +-+-+ +-+-+ +-+ + + + +
| | | | |   |     |     |         | |   |
+ + + + + + + +-+-+ +-+-+ +-+-+-+-+ +-+ +
| |   |   | | |     |   |       |   |   |
+ +-+-+-+-+ + +-+-+ + + +-+-+-+ +-+-+ + +
|     |     |     |   | |         |   | |
+-+-+ + +-+-+-+-+ +-+-+ +-+-+-+ + + +-+ +
|     |       |   |   |   |     | | |   |
+ +-+-+-+ +-+ + +-+ + +-+ +-+-+-+ + +-+ +
| |     | |   | | | |   |         |   | |
+ + +-+ + +-+-+ + + +-+ +-+-+ +-+-+-+ + +
|   |   | |   |   | | | |   | |       | |
+-+-+ +-+ + + +-+ + + + + + + + +-+-+-+ +
|     |   | | |   | | |   | |         | |
+ +-+-+ +-+-+ + + + + +-+-+ +-+-+-+-+ +-+
| |       |   | | | |       |     |     |
+ +-+-+ + + +-+-+ + +-+-+-+-+-+-+ +-+-+ +
|     | | | |       | |   |   | |   |   |
+-+-+ + +-+ + +-+-+-+ + + +-+ + + + + + +
|     |   | |       |   | |   |   |   | |
+ +-+-+-+ + + +-+ + + +-+ + +-+-+-+-+-+ +
| |     | | |   | |   |   | |   |       |
+ +-+ + + + +-+-+ +-+-+ +-+ + +-+ + +-+-+
|     |   | |   | |     |   |   | |   | |
+ +-+-+-+-+ + + + + +-+-+ +-+-+ + +-+ + +
| |         | |   |   |   |   |   |   | |
+ + +-+ +-+-+ +-+-+ + + +-+ + +-+-+ +-+ +
|     |       |     |   |   |           S
+-+-+-+-+-+-+-+-+-+-+-+-+-+-+-+-+-+-+-+-+
