+-+-+-+-+-+-+-+-+-+-+
E   |       |   |   |
+ + + +-+-+ +-+ + + +
| | | |   | |     | |
+ + +-+ + + + + +-+-+
| |     |     | |   |
+ +-+ +-+-+-+-+ + + +
|   | |     |   | | |
+-+ + + +-+ + +-+ + +
| | |   |   |   | | |
+ + +-+-+ +-+-+ +-+ +
|   |     |   |     |
+-+-+ +-+-+ + +-+ +-+
|   | |   | |   |   |
+-+ + +-+ + +-+ +-+-+
|   | |     | |     |
+ +-+ + +-+-+ +-+-+ +
|     | |     |     |
+ + +-+ + +-+-+ +-+-+
| |     |           S
+-+-+-+-+-+-+-+-+-+-+